{
  "room": 14,
  "roomSize": 20,
  "blocks": [
    "####################",
    "#C................C#",
    "#..................#",
    "#........CC........#",
    "#........CC........#",
    "#........##!.......#",
    "#..................#",
    "#..................#",
    "#..................#",
    "#..................#",
    "#..................#",
    "#.............F....#",
    "#....#........#....#",
    "#..................#",
    "#..................#",
    "#..................#",
    "#..................#",
    "#..................#",
    "#!................!#",
    "####----############"
  ],
  "surfacePlagues": [],
  "controlBindings": [],
  "lightningChains": [],
  "lightningNodes": [],
  "emitters": [],
  "sequencers": [],
  "targetDefaults": {},
  "enemyPatrols": [],
  "spawn": {
    "x": 100,
    "y": 580
  }
}
