{
  "room": 16,
  "roomSize": 40,
  "blocks": [
    "########################################",
    "#......................................#",
    "#......................................#",
    "#......................................#",
    "#......................................#",
    "#......................................#",
    "#......................................#",
    "#......................................#",
    "#......................................#",
    "#......................................#",
    "#......................................#",
    "#......................................#",
    "#......................................#",
    "#......................................#",
    "#......................................#",
    "#......................................#",
    "#......................................#",
    "#......................................#",
    "#......................................#",
    "#......................................#",
    "#......................................#",
    "#......................................#",
    "#......................................#",
    "#......................................#",
    "#......................................#",
    "#......................................#",
    "#......................................#",
    "#......................................#",
    "#......................................#",
    "#......................................#",
    "#......................................#",
    "#......................................#",
    "#......................................#",
    "#......................................#",
    "#......................................#",
    "#......................................#",
    "#......................................#",
    "#......................................#",
    "########################################",
    "########################################"
  ],
  "surfacePlagues": [],
  "controlBindings": [],
  "lightningChains": [],
  "lightningNodes": [],
  "emitters": [],
  "sequencers": [],
  "targetDefaults": {},
  "enemyPatrols": [],
  "advancedEnemies": [],
  "spawn": {
    "x": 68,
    "y": 548
  }
}
