{
  "room": 13,
  "roomSize": 40,
  "blocks": [
    "########################################",
    "#......................................#",
    "#......................................#",
    "#......................................#",
    "#......................................#",
    "#......................................#",
    "#......................................#",
    "#......................................#",
    "#.......................................",
    "#.......................................",
    "#.......................................",
    "#.......................................",
    "#.................................######",
    "#......................................#",
    "#......................................#",
    "#......................................#",
    "#......................................#",
    "#......................................#",
    "#......................................#",
    "#......................................#",
    "#......................................#",
    "#......................................#",
    "#......................................#",
    "#......................................#",
    "#......................................#",
    "#......................................#",
    "#......................................#",
    "#......................................#",
    "#......................................#",
    "#......................................#",
    "#......................................#",
    "#......................................#",
    "#......................................#",
    "#......................................#",
    "#......................................#",
    "#......................................#",
    "#......................................#",
    "#......................................#",
    "#......................................#",
    "########################################"
  ],
  "surfacePlagues": [],
  "controlBindings": [],
  "lightningChains": [],
  "lightningNodes": [],
  "emitters": [],
  "sequencers": [],
  "targetDefaults": {},
  "enemyPatrols": [],
  "spawn": {
    "x": 1220,
    "y": 324
  }
}
