{
  "room": 17,
  "roomSize": 20,
  "blocks": [
    "####################",
    "#..................#",
    "#..................#",
    "#..................#",
    "#..................#",
    "#..................#",
    "#..................#",
    "#..................#",
    "#..................#",
    "#..................#",
    "#..................#",
    "#..................#",
    "#..................#",
    "#..................#",
    "#..................#",
    "#..................#",
    "#..................#",
    "#..................#",
    "####################",
    "####################"
  ],
  "surfacePlagues": [],
  "controlBindings": [],
  "lightningChains": [],
  "lightningNodes": [],
  "emitters": [],
  "sequencers": [],
  "targetDefaults": {},
  "enemyPatrols": [],
  "advancedEnemies": [],
  "spawn": {
    "x": 68,
    "y": 356
  }
}
