{
  "version": 1,
  "cols": 20,
  "rows": 20,
  "rooms": [
    {
      "room": 1,
      "blocks": [
        "####....############",
        "#..................#",
        "#..................#",
        "#....==............#",
        "#..................#",
        "#..................#",
        "#..................#",
        "#..................#",
        "#..................#",
        "#..................#",
        "#........####......#",
        "#..................#",
        "#..................#",
        "#..................#",
        "#...####......####.#",
        "#...................",
        "#...................",
        "#.F.................",
        "####################",
        "####################"
      ],
      "surfacePlagues": [
        {
          "x": 7,
          "y": 18,
          "face": 0
        },
        {
          "x": 8,
          "y": 18,
          "face": 0
        },
        {
          "x": 9,
          "y": 18,
          "face": 0
        },
        {
          "x": 11,
          "y": 18,
          "face": 0
        },
        {
          "x": 10,
          "y": 18,
          "face": 0
        },
        {
          "x": 12,
          "y": 18,
          "face": 0
        },
        {
          "x": 13,
          "y": 18,
          "face": 0
        },
        {
          "x": 14,
          "y": 18,
          "face": 0
        },
        {
          "x": 15,
          "y": 18,
          "face": 0
        }
      ],
      "spawn": {
        "x": 68,
        "y": 548
      }
    },
    {
      "room": 2,
      "blocks": [
        "#########!##########",
        "#..................#",
        "#..............#...#",
        "#.............##...#",
        "#............#.#...#",
        "#...#.......#..#...#",
        "#...#......#...#...#",
        "#...#......#...#...#",
        "....#......#..#....#",
        "....#......#.#.....#",
        "....#......##......#",
        "#####......#.......#",
        "#..................#",
        "#..................#",
        "#..................#",
        "........#R#.........",
        "........###.........",
        "..F....#####........",
        "####################",
        "####################"
      ],
      "surfacePlagues": [],
      "spawn": {
        "x": 68,
        "y": 548
      }
    },
    {
      "room": 3,
      "blocks": [
        "####################",
        "#..........#.......#",
        "#..........#.......#",
        "#.===...............",
        "#......====.........",
        "#............####...",
        "#................###",
        "#......###.........#",
        "#.............#....#",
        "#.............#....#",
        "#.............#....#",
        "#...===..###..#....#",
        "#.............#....#",
        "#.............#..###",
        "#..................#",
        "...................#",
        "...................#",
        "..F....!!!...!!!...#",
        "####################",
        "####################"
      ],
      "surfacePlagues": [],
      "spawn": {
        "x": 68,
        "y": 548
      }
    },
    {
      "room": 4,
      "blocks": [
        "####################",
        "#.....#..L.........#",
        "#.....#..L........#.",
        "......#..L.......#..",
        "......#..L......#...",
        "..F......L...###...#",
        "####.....L..#~~~~.#!",
        "#........L..##..#..!",
        "#......##L..#.......",
        "#........#...###....",
        "###......#......####",
        "#........#..........",
        "#......###..#.......",
        "#...........###.....",
        "###..............###",
        "#..................#",
        "#......###..#.......",
        "#...........#.......",
        "#.!!!!......#.......",
        "####################"
      ],
      "surfacePlagues": [],
      "spawn": {
        "x": 68,
        "y": 164
      }
    },
    {
      "room": 5,
      "blocks": [
        "#...############---#",
        "#.==#..............#",
        "#...#..............#",
        "#...#..............#",
        "#.==#..............#",
        "#...#......!!......#",
        "#...#......!.......#",
        "#.==#......#....####",
        "#...#......#.......#",
        "#...####...#.......#",
        "#.==#......####....#",
        "....#......#.......#",
        "....#......#.......#",
        "..###......#.....###",
        "##......####.......#",
        "#..........#...!!!!#",
        "...........#.......#",
        "...........#.......#",
        "..F........#.......#",
        "################...#"
      ],
      "surfacePlagues": [],
      "spawn": {
        "x": 68,
        "y": 580
      }
    },
    {
      "room": 6,
      "blocks": [
        "################...#",
        "#...........J......#",
        "#...........J....F.#",
        "#...............####",
        "#............#!!!..#",
        "#........#!!!......#",
        "#....#!!!..........#",
        "#....L.............#",
        "##.................#",
        "#..................#",
        "#.!!#..............#",
        "#....!!!#..........#",
        "#........!!!#......#",
        "#............!!!#..#",
        "#..................#",
        "#..................#",
        "#..........###.....#",
        "#............#.....#",
        "#...####!!!..#...!!#",
        "#...################"
      ],
      "surfacePlagues": [],
      "spawn": {
        "x": 548,
        "y": 68
      }
    },
    {
      "room": 7,
      "blocks": [
        "#...################",
        "#..................#",
        "#..................#",
        "#..................#",
        "#..................#",
        "#..................#",
        "#..................#",
        "#..................#",
        "#..................#",
        "#..................#",
        "#..................#",
        "#..................#",
        "#..................#",
        "#..................#",
        "#..................#",
        "#..................#",
        "#..................#",
        "#..................#",
        "####################",
        "####################"
      ],
      "surfacePlagues": [],
      "spawn": {
        "x": 68,
        "y": 548
      }
    }
  ]
}
