{
  "room": 2,
  "blocks": [
    "#########!##########",
    "#..................#",
    "#..............#...#",
    "#.............##...#",
    "#............#.#...#",
    "#...#.......#..#...#",
    "#...#......#...#...#",
    "#...#......#...#...#",
    "....#......#..#....#",
    "....#......#.#.....#",
    "....#......##......#",
    "#####......#.......#",
    "#..................#",
    "#..................#",
    "#..................#",
    "........#R#.........",
    "........###.........",
    "..F....#####........",
    "####################",
    "####################"
  ],
  "surfacePlagues": [],
  "spawn": {
    "x": 68,
    "y": 548
  }
}
