{
  "room": 5,
  "blocks": [
    "#...############---#",
    "#.==#..............#",
    "#...#..............#",
    "#...#..............#",
    "#.==#..............#",
    "#...#......!!......#",
    "#...#......!.......#",
    "#.==#......#....####",
    "#...#......#.......#",
    "#...####...#.......#",
    "#.==#......####....#",
    "....#......#.......#",
    "....#......#.......#",
    "..###......#.....###",
    "##......####.......#",
    "#..........#...!!!!#",
    "...........#.......#",
    "...........#.......#",
    "..F........#.......#",
    "################...#"
  ],
  "surfacePlagues": [],
  "spawn": {
    "x": 68,
    "y": 580
  }
}
