{
  "room": 12,
  "roomSize": 20,
  "blocks": [
    "####################",
    "#..................#",
    "...................#",
    "...................#",
    "#..................#",
    "#..................#",
    "#..................#",
    "#..................#",
    "#..................#",
    "#..................#",
    "#..................#",
    "#..................#",
    "#..................#",
    "#..................#",
    "#..................#",
    "#..................#",
    "#..................#",
    "#..................#",
    "#..................#",
    "####################"
  ],
  "surfacePlagues": [],
  "controlBindings": [],
  "lightningChains": [],
  "lightningNodes": [],
  "emitters": [],
  "sequencers": [],
  "targetDefaults": {},
  "enemyPatrols": [],
  "advancedEnemies": [],
  "movingPlatforms": [],
  "platformGenerators": [],
  "dropBosses": [],
  "routeBosses": [],
  "finalBosses": [],
  "gravityZones": [],
  "spawn": {
    "x": 4,
    "y": 68
  }
}
