{
  "room": 11,
  "roomSize": 20,
  "blocks": [
    "####################",
    "#..................#",
    "#..................H",
    "#..................H",
    "#..................#",
    "#..................#",
    "#..................#",
    "#..................#",
    "...................#",
    "...................#",
    "...................#",
    "...................#",
    "#..................#",
    "#..................#",
    "###................#",
    "#..................#",
    "#..................#",
    "#..................#",
    "#......F...........#",
    "########----########"
  ],
  "surfacePlagues": [],
  "controlBindings": [],
  "lightningChains": [],
  "lightningNodes": [],
  "emitters": [],
  "sequencers": [],
  "targetDefaults": {},
  "enemyPatrols": [],
  "spawn": {
    "x": 68,
    "y": 580
  }
}
