{
  "room": 16,
  "roomSize": 20,
  "blocks": [
    "####################",
    "#...................",
    "#...................",
    "#...............A...",
    "#...............####",
    "#..............#...#",
    "#............##....#",
    "#...........##.....#",
    "#..........#.......#",
    "#.........#........#",
    "#..................#",
    "#..................#",
    "#..................#",
    "#...--....--.......#",
    "#.................##",
    "#...............####",
    "===..<...^..>.......",
    "....................",
    "DF#!!!!!!!!!!!!!####",
    "####################"
  ],
  "surfacePlagues": [],
  "controlBindings": [],
  "lightningChains": [],
  "lightningNodes": [],
  "emitters": [],
  "sequencers": [],
  "targetDefaults": {},
  "enemyPatrols": [],
  "spawn": {
    "x": 36,
    "y": 548
  }
}
