{
  "room": 3,
  "blocks": [
    "####################",
    "#..........#.......#",
    "#..........#.......#",
    "#.===...............",
    "#......====.........",
    "#............####...",
    "#................###",
    "#......###.........#",
    "#.............#....#",
    "#.............#....#",
    "#.............#....#",
    "#...===..###..#....#",
    "#.............#....#",
    "#.............#..###",
    "#..................#",
    "...................#",
    "...................#",
    "..F....!!!...!!!...#",
    "####################",
    "####################"
  ],
  "surfacePlagues": [],
  "spawn": {
    "x": 68,
    "y": 548
  }
}
