{
  "room": 7,
  "blocks": [
    "#...################",
    "#..................#",
    "#..................#",
    "#..................#",
    "#..................#",
    "#..................#",
    "#..................#",
    "#..................#",
    "#..................#",
    "#..................#",
    "#..................#",
    "#..................#",
    "#..................#",
    "#..................#",
    "#..................#",
    "#..................#",
    "#..................#",
    "#..................#",
    "####################",
    "####################"
  ],
  "surfacePlagues": [],
  "spawn": {
    "x": 68,
    "y": 548
  }
}
