{
  "room": 6,
  "blocks": [
    "##########..####...#",
    "#.........HC#.!....#",
    "#.........###....F.#",
    "#...............####",
    "#............#!!!..#",
    "#........C!!!......#",
    "#....!!!!..........#",
    "#....L.............#",
    "##.................#",
    "#..................#",
    "#.!!#..............#",
    "#....!!!!..C.......#",
    "#........!!!#......#",
    "#............!!!#..#",
    "#..................#",
    "#..................#",
    "#..........###.....#",
    "#............#.....#",
    "#===####!!!..#...!!#",
    "#...################"
  ],
  "surfacePlagues": [],
  "controlBindings": [],
  "lightningNodes": [],
  "enemyPatrols": [],
  "spawn": {
    "x": 100,
    "y": 548
  }
}
