{
  "room": 4,
  "blocks": [
    "####################",
    "#.....#..L.........#",
    "#.....#..L........#.",
    "......#..L.......#..",
    "......#..L......#...",
    "..F......L...###...#",
    "####.....L..#~~~~.#!",
    "#........L..##..#..!",
    "#......##L..#.......",
    "#........#...###....",
    "###......#......####",
    "#........#..!.......",
    "#......###..#!!.....",
    "#...........###.....",
    "###..............###",
    "#..................#",
    "#......###..#.......",
    "#...........#.......",
    "#C!!!!......#.......",
    "####################"
  ],
  "surfacePlagues": [],
  "controlBindings": [],
  "lightningNodes": [],
  "enemyPatrols": [],
  "spawn": {
    "x": 68,
    "y": 164
  }
}
