{
  "room": 3,
  "blocks": [
    "####################",
    "#.!........#.......#",
    "#.C........!.......#",
    "#.=.................",
    "#C..................",
    "#............####...",
    "#...............!###",
    "#......###.........#",
    "#.............#....#",
    "#.............#....#",
    "#.............#....#",
    "#..!!....###..#....#",
    "#.............#!...#",
    "#.............#..###",
    "#..................#",
    "...................#",
    "...................#",
    "..F....!!!...!!!...#",
    "####################",
    "####################"
  ],
  "surfacePlagues": [],
  "controlBindings": [],
  "lightningNodes": [],
  "enemyPatrols": [],
  "spawn": {
    "x": 68,
    "y": 548
  }
}
