{
  "room": 8,
  "blocks": [
    "####################",
    "#...#...#...#...#HH#",
    "#...#...#...#...#HH#",
    "#...#...#...#...#..#",
    "#...#...#...#...#..C",
    "#...#...#...#...#..C",
    "#...!...#...!...#..C",
    "#.......#.......#.=#",
    "#.......!.......#..#",
    "#...............#..#",
    "#...!.......!...!..#",
    "#...#.......#.....=#",
    "#=..#...!...#......#",
    "#...#...#...#......#",
    "#...#...#.=.#...!..#",
    "#...#...#...#...#..#",
    "#...#...#...#...#.=#",
    "#.F.#...#...#...#..#",
    "#===!!!!!!!!!!!!!!!#",
    "#...################"
  ],
  "surfacePlagues": [],
  "controlBindings": [],
  "lightningNodes": [],
  "enemyPatrols": [],
  "spawn": {
    "x": 68,
    "y": 548
  }
}
