{
  "room": 6,
  "blocks": [
    "################...#",
    "#...........J......#",
    "#...........J....F.#",
    "#...............####",
    "#............#!!!..#",
    "#........#!!!......#",
    "#....#!!!..........#",
    "#....L.............#",
    "##.................#",
    "#..................#",
    "#.!!#..............#",
    "#....!!!#..........#",
    "#........!!!#......#",
    "#............!!!#..#",
    "#..................#",
    "#..................#",
    "#..........###.....#",
    "#............#.....#",
    "#...####!!!..#...!!#",
    "#...################"
  ],
  "surfacePlagues": [],
  "spawn": {
    "x": 548,
    "y": 68
  }
}
